1111111
10P0001
1000001
10000E1
1111111
