1111111
10P0001
100C001
10P00E1
1111111
