1111111
10P00E1
100C001
10000E1
1111111
