1111111
1000001
100C001
10000E1
1111111
