1111111
10P0001
100C000
10000E1
1111111
