1111111
10P0001
100C001
10000E1
1111111
